11111111111111111111111111111111111111111111111111111111111111111111111111111111
10000000000000000000000000000000000000000000000000000000000000000000000000000001
10111111111111000000000000000000000000000000000000000000000000000000000000000001
10111111111111000000000000000000000000000000000000000000000000000000000000000001
10111111111111000000000000000000000000000000000000000000000000000000000000000001
10111111111111000000110001100011000110001100011000110001100000000000000000000001
10111111111111000000110001100011000110001100011000110001100000000000000000000001
10111111111111000000110001100011000110001100011000110001100000000000000000000001
10111111111111000000110001100011000110001100011000110001100000000000000000000001
10111111111111000000000001100000000110000000011000000001100000000000000000000001
10000000000000000000000001100000000110000000011000000001100000000000000000000001
10000000000000000000110001100011000110001100011000110001100000000000000000000001
10000000110000000000110000000011000000001100000000110000000000000000000000000001
10000000110000000000110000000011000000001100000000110000000000000000000000000001
10000000000000011110110001100011000110001100011000110001100000000000000000000001
10000000000000011110000000000000000000000000000000000000000000000000000000000001
10000000000000011110000000000000000000000000000000000000000000000000001100000001
10000000000000011110000000000000000000000000000000000000000000000000001100000001
10000000000011110000000001100000000110000000011000000001100000000000000000000001
10000000000011110000110001100011000110001100011000110001100000000000000000000001
10000000001111110000110000000011000000001100000000110000000000000000000000000001
10000000001111110000110000000011000000001100000000110000000000000000000000000001
10000000000000000000110001100011000110001100011000110001100000000000000000000001
10000000000000000000110001100011000110001100011000110001100000000000000000000001
10000000000000000000110001100011000110001100011000110001100000000000000000000001
10000000000000000000000001100000000110000000011000000001100000000000000000000001
10000000000000000000000001100000000110000000011000000001100000000000000000000001
10000000000000000000110001100011000110001100011000110001100000000000000000000001
10000000000000000000110000000011000000001100000000110000000000000000000011000001
10000000000000000000110000000011000000001100000000110000000000000000000011000001
10000000000000000000110001100011000110001100011000110001100000000000000000000001
10000000000000000000110001100011000110001100011000110001100000000000000000000001
10000000110000000000000000000000000000000000000000000000000000000000000000000001
10000000110000000000000000000000000000000000000000000000000000000000000000000001
10000000000000000000000000000000000000000000000000000000000000000000000000000001
10000000000000000000110001100011000110001100011000110001100000000000000000000001
10000000000000000000000000000000000000000000000000000000000000000000000000000001
10000000000000000000000000000000000000000000000000000000000000000000000000000001
10000000000000000000000000000000000000000000000000000000000000001111111111111101
10000000000000000000000000000000000000000000000000000000000000001111111111111101
10000000000000000000000000000000000000000000000000000000000000001111111111111101
10000000000000000000000000000000000000000000000000000000000000001111111111111101
10000000000000000000000000000000000000000000000000000000000000001111111111111101
10000000000000000000000000000000000000000000000000000000000000001111111111111101
10000000000000000000000000000000000000000000000000000000000000001111111111111101
10000000000000000000000000000000000000000000000000000000000000001111111111111101
10000000000000000000000000000000000000000000000000000000000000001111111111111101
10000000000000000000000000000000000000000000000000000000000000001111111111111101
10000000000000000000000000000000000000000000000000000000000000000000000000000001
11111111111111111111111111111111111111111111111111111111111111111111111111111111
